#|#################
#|#|||||#||||||||||
#|##||#|#|#########
#||#||###|#|||||||#
#||#||||||#######|#
#||#|###||#||#||#|#
#||#|#|||||||#||||#
###################
