|||||||||||||||||||||
|#|#################|
|#|#|||||#|||||||||||
|#|##||#|#|#########|
|#||#||###|#|||||||#|
|#||#||||||#######|#|
|#||#|###||#||#||#|#|
|#||#|#|||||||#||||#|
|###################|
|||||||||||||||||||||