# ########
# ### ## #
#  #     #
##   # # #
### ## # #
#   ######
###      #
#   ## ###
## ##    #
######## #