# ################
#  ##  ## # # #  #
## #  ##  # # # ##
## # ####     #  #
#    ########   ##
####  ##   ####  #
# ###  ## ## ## ##
# # # ##      #  #
# # #  ##### ## ##
#   # ## # #     #
###    #     #####
######   # #######
#      ###       #
# # # ##   # ## ##
############### ##
