##################
#   ##  ##  ##   #
###  ##  ##  ## ##
#   ##  ##  ##   #
# #  ## ### #  ###
####  # # # # ## #
## ## # # # #    #
#  ## # #     # ##
## ## #   ### ####
## ## # #  ##### #
#   # # #### # # #
### # #  ##  #   #
#   #   ### ## ###
# #   #          #
##################
