#.##################
#.# ## # ##   #    #
#...# ,,,,,,### ## #
###.##,####,, #  ###
# .,,,,## ##,## ####
###,##     #,,,,,# #
# *, ## # ## # #,  #
## # #  # ## ###,###
#  #### #  #  ##,  #
##   ## ## # ###,###
## #### ## # #  ,  #
#     # ## # # #,# #
## #### ## # # #,###
#     #  ### ###,,,#
## #### ##   #####,#
#   ### ## #    ##,#
# #   #  ### ##  #,#
# # ######    ## #,#
# #      # # ##  #,#
##################,#
