# ##################
# # ## # ##   #    #
#   #       ### ## #
### ## ####   #  ###
#      ## ## ## ####
### ##     #     # #
#    ## # ## # #   #
## # #  # ## ### ###
#  #### #  #  ##   #
##   ## ## # ### ###
## #### ## # #     #
#     # ## # # # # #
## #### ## # # # ###
#     #  ### ###   #
## #### ##   ##### #
#   ### ## #    ## #
# #   #  ### ##  # #
# # ######    ## # #
# #      # # ##  # #
################## #
