# ########
# #   ## #
# ###  # #
# # # ## #
# # # ## #
# # # #  #
#   # ## #
# #   ## #
# # #    #
######## #
